ADE = "countries/ADE.txt"
AFG = "countries/AFG.txt"
AHV = "countries/AHV.txt"
ALA = "countries/ALA.txt"
ALB = "countries/ALB.txt"
ALE = "countries/ALE.txt"
ALG = "countries/ALG.txt"
AND = "countries/AND.txt"
ANG = "countries/ANG.txt"
ARG = "countries/ARG.txt"
ARM = "countries/ARM.txt"
ASI = "countries/ASI.txt"
ASS = "countries/ASS.txt"
AST = "countries/AST.txt"
AUS = "countries/AUS.txt"
AZR = "countries/AZR.txt"
BAH = "countries/BAH.txt"
BAS = "countries/BAS.txt"
BEL = "countries/BEL.txt"
BGU = "countries/BGU.txt"
BHU = "countries/BHU.txt"
BLR = "countries/BLR.txt"
BOL = "countries/BOL.txt"
BOS = "countries/BOS.txt"
BOT = "countries/BOT.txt"
BRA = "countries/BRA.txt"
BRU = "countries/BRU.txt"
BUC = "countries/BUC.txt"
BUK = "countries/BUK.txt"
BUL = "countries/BUL.txt"
BUR = "countries/BUR.txt"
BZE = "countries/BZE.txt"
CAM = "countries/CAM.txt"
CAN = "countries/CAN.txt"
CAR = "countries/CAR.txt"
CEY = "countries/CEY.txt"
CHI = "countries/CHI.txt"
CHL = "countries/CHL.txt"
CLA = "countries/CLA.txt"
COC = "countries/COC.txt"
COG = "countries/COG.txt"
COL = "countries/COL.txt"
COS = "countries/COS.txt"
COU = "countries/COU.txt"
CRI = "countries/CRI.txt"
CRO = "countries/CRO.txt"
CRU = "countries/CRU.txt"
CUB = "countries/CUB.txt"
CYP = "countries/CYP.txt"
CYR = "countries/CYR.txt"
CZE = "countries/CZE.txt"
DAL = "countries/DAL.txt"
DAN = "countries/DAN.txt"
DAR = "countries/DAR.txt"
DDR = "countries/DDR.txt"
DEN = "countries/DEN.txt"
DER = "countries/DER.txt"
DJI = "countries/DJI.txt"
DKR = "countries/DKR.txt"
DOM = "countries/DOM.txt"
DON = "countries/DON.txt"
DRU = "countries/DRU.txt"
ECU = "countries/ECU.txt"
EGY = "countries/EGY.txt"
ELS = "countries/ELS.txt"
ENG = "countries/ENG.txt"
ERI = "countries/ERI.txt"
ERZ = "countries/ERZ.txt"
EST = "countries/EST.txt"
ETH = "countries/ETH.txt"
FAR = "countries/FAR.txt"
FEA = "countries/FEA.txt"
FGU = "countries/FGU.txt"
FIN = "countries/FIN.txt"
FIU = "countries/FIU.txt"
FPO = "countries/FPO.txt"
FRA = "countries/FRA.txt"
FSR = "countries/FSR.txt"
FWA = "countries/FWA.txt"
GAL = "countries/GAL.txt"
GAM = "countries/GAM.txt"
GCO = "countries/GCO.txt"
GEO = "countries/GEO.txt"
GER = "countries/GER.txt"
GIL = "countries/GIL.txt"
GMJ = "countries/GMJ.txt"
GND = "countries/GND.txt"
GRE = "countries/GRE.txt"
GUA = "countries/GUA.txt"
GUK = "countries/GUK.txt"
GXC = "countries/GXC.txt"
GZH = "countries/GZH.txt"
HAI = "countries/HAI.txt"
HAW = "countries/HAW.txt"
HEJ = "countries/HEJ.txt"
HOB = "countries/HOB.txt"
HOL = "countries/HOL.txt"
HON = "countries/HON.txt"
HUN = "countries/HUN.txt"
ICE = "countries/ICE.txt"
IDE = "countries/IDE.txt"
ING = "countries/ING.txt"
INS = "countries/INS.txt"
IRE = "countries/IRE.txt"
IRQ = "countries/IRQ.txt"
ISR = "countries/Israel.txt"
IST = "countries/IST.txt"
ITA = "countries/ITA.txt"
JAB = "countries/JAB.txt"
JAM = "countries/JAM.txt"
JAP = "countries/JAP.txt"
JOR = "countries/JOR.txt"
KAM = "countries/KAM.txt"
KAR = "countries/KAR.txt"
KAZ = "countries/KAZ.txt"
KEN = "countries/KEN.txt"
KHI = "countries/KHI.txt"
KIR = "countries/KIR.txt"
KOR = "countries/KOR.txt"
KUB = "countries/KUB.txt"
KUW = "countries/KUW.txt"
LAO = "countries/LAO.txt"
LAT = "countries/LAT.txt"
LBA = "countries/LBA.txt"
LEB = "countries/LEB.txt"
LEE = "countries/LEE.txt"
LIB = "countries/LIB.txt"
LIE = "countries/LIE.txt"
LIT = "countries/LIT.txt"
LOM = "countries/LOM.txt"
LUX = "countries/LUX.txt"
MAD = "countries/MAD.txt"
MAJ = "countries/MAJ.txt"
MAL = "countries/MAL.txt"
MAN = "countries/MAN.txt"
MCO = "countries/MCO.txt"
MEN = "countries/MEN.txt"
MEX = "countries/MEX.txt"
MNT = "countries/MNT.txt"
MOD = "countries/MOD.txt"
MOL = "countries/MOL.txt"
MON = "countries/MON.txt"
MOR = "countries/MOR.txt"
MOU = "countries/MOU.txt"
MTA = "countries/MTA.txt"
MZB = "countries/MZB.txt"
NAM = "countries/NAM.txt"
NEP = "countries/NEP.txt"
NFL = "countries/NFL.txt"
NGA = "countries/NGA.txt"
NIC = "countries/NIC.txt"
NIG = "countries/NIG.txt"
NOR = "countries/NOR.txt"
NYA = "countries/NYA.txt"
NZL = "countries/NZL.txt"
OBE = "countries/OBE.txt"
ODE = "countries/ODE.txt"
OMA = "countries/OMA.txt"
PAK = "countries/PAK.txt"
PAL = "countries/PAL.txt"
PAN = "countries/PAN.txt"
PAP = "countries/PAP.txt"
PAR = "countries/PAR.txt"
PER = "countries/PER.txt"
PHI = "countries/PHI.txt"
PMA = "countries/PMA.txt"
POL = "countries/POL.txt"
PON = "countries/PON.txt"
POR = "countries/POR.txt"
PRC = "countries/PRC.txt"
PRU = "countries/PRU.txt"
PSR = "countries/PSR.txt"
PUE = "countries/PUE.txt"
RAJ = "countries/RAJ.txt"
ROM = "countries/ROM.txt"
RUA = "countries/RUA.txt"
RUS = "countries/RUS.txt"
SAA = "countries/SAA.txt"
SAF = "countries/SAF.txt"
SAL = "countries/SAL.txt"
SAN = "countries/SAN.txt"
SAR = "countries/SAR.txt"
SAU = "countries/SAU.txt"
SAV = "countries/SAV.txt"
SER = "countries/Serbia.txt"
SHX = "countries/SHX.txt"
SIA = "countries/SIA.txt"
SIC = "countries/SIC.txt"
SIE = "countries/SIE.txt"
SIK = "countries/SIK.txt"
SIL = "countries/SIL.txt"
SLA = "countries/SLA.txt"
SLO = "countries/SLO.txt"
SOM = "countries/SOM.txt"
SOV = "countries/SOV.txt"
SPR = "countries/SPR.txt"
SRU = "countries/SRU.txt"
STY = "countries/STY.txt"
SUD = "countries/SUD.txt"
SUR = "countries/SUR.txt"
SWA = "countries/SWA.txt"
SWE = "countries/SWE.txt"
SWI = "countries/SWI.txt"
SYR = "countries/SYR.txt"
TAI = "countries/TAI.txt"
TAJ = "countries/TAJ.txt"
TAN = "countries/TAN.txt"
TAR = "countries/TAR.txt"
TAT = "countries/TAT.txt"
TGA = "countries/TGA.txt"
TIA = "countries/TIA.txt"
TIB = "countries/TIB.txt"
TOG = "countries/TOG.txt"
TON = "countries/TON.txt"
TRA = "countries/TRA.txt"
TRI = "countries/TRI.txt"
TRU = "countries/TRU.txt"
TUA = "countries/TUA.txt"
TUN = "countries/TUN.txt"
TUR = "countries/TUR.txt"
TUS = "countries/TUS.txt"
TYR = "countries/TYR.txt"
UGA = "countries/UGA.txt"
UKR = "countries/UKR.txt"
URG = "countries/URG.txt"
USA = "countries/USA.txt"
VEN = "countries/VEN.txt"
VIL = "countries/VIL.txt"
VIN = "countries/VIN.txt"
VOL = "countries/VOL.txt"
WGR = "countries/WGR.txt"
WIN = "countries/WIN.txt"
WPT = "countries/WPT.txt"
XSM = "countries/XSM.txt"
YEM = "countries/YEM.txt"
YUG = "countries/YUG.txt"
YUN = "countries/YUN.txt"
ZAN = "countries/ZAN.txt"
ZHI = "countries/ZHI.txt"
ZIM = "countries/ZIM.txt"
